__#___#______#G
#___#___#####__
__#####_###___#
_##_______#_##_
__#_#####_#_#__
#_#_#___#_#___#
__#_#_#M#_###__
_##_#_###_#_##_
__#_#_____#_##_
#_#_#######_##_
__#_________#__
_#######_####_#
__##___#_______
###__#__#_###_#
____#______#___